"filename", "language", "C#", "comment", "blank", "total"
"/Users/giorasmacbook/Library/CloudStorage/OneDrive-Personal/MyLife/Giora/לימודים/הנדסאים/שנה ב/A FINAL PROJECT/PokerMate/SEM A FINAL JOBS/OOP Divers/FINAL SESTER A OOP/ConsoleApp1/ConsoleApp1/Classes/CHumans/Diver.cs", "C#", 133, 17, 9, 159
"/Users/giorasmacbook/Library/CloudStorage/OneDrive-Personal/MyLife/Giora/לימודים/הנדסאים/שנה ב/A FINAL PROJECT/PokerMate/SEM A FINAL JOBS/OOP Divers/FINAL SESTER A OOP/ConsoleApp1/ConsoleApp1/Classes/CHumans/DiverInstructor.cs", "C#", 44, 7, 5, 56
"/Users/giorasmacbook/Library/CloudStorage/OneDrive-Personal/MyLife/Giora/לימודים/הנדסאים/שנה ב/A FINAL PROJECT/PokerMate/SEM A FINAL JOBS/OOP Divers/FINAL SESTER A OOP/ConsoleApp1/ConsoleApp1/Classes/CHumans/Person.cs", "C#", 132, 10, 25, 167
"/Users/giorasmacbook/Library/CloudStorage/OneDrive-Personal/MyLife/Giora/לימודים/הנדסאים/שנה ב/A FINAL PROJECT/PokerMate/SEM A FINAL JOBS/OOP Divers/FINAL SESTER A OOP/ConsoleApp1/ConsoleApp1/Classes/CHumans/User.cs", "C#", 36, 4, 6, 46
"/Users/giorasmacbook/Library/CloudStorage/OneDrive-Personal/MyLife/Giora/לימודים/הנדסאים/שנה ב/A FINAL PROJECT/PokerMate/SEM A FINAL JOBS/OOP Divers/FINAL SESTER A OOP/ConsoleApp1/ConsoleApp1/Classes/CLocations/Address.cs", "C#", 66, 3, 2, 71
"/Users/giorasmacbook/Library/CloudStorage/OneDrive-Personal/MyLife/Giora/לימודים/הנדסאים/שנה ב/A FINAL PROJECT/PokerMate/SEM A FINAL JOBS/OOP Divers/FINAL SESTER A OOP/ConsoleApp1/ConsoleApp1/Classes/CLocations/Country.cs", "C#", 41, 3, 5, 49
"/Users/giorasmacbook/Library/CloudStorage/OneDrive-Personal/MyLife/Giora/לימודים/הנדסאים/שנה ב/A FINAL PROJECT/PokerMate/SEM A FINAL JOBS/OOP Divers/FINAL SESTER A OOP/ConsoleApp1/ConsoleApp1/Classes/CLocations/DivingClub.cs", "C#", 133, 7, 11, 151
"/Users/giorasmacbook/Library/CloudStorage/OneDrive-Personal/MyLife/Giora/לימודים/הנדסאים/שנה ב/A FINAL PROJECT/PokerMate/SEM A FINAL JOBS/OOP Divers/FINAL SESTER A OOP/ConsoleApp1/ConsoleApp1/Classes/CLocations/DivingSite.cs", "C#", 67, 4, 4, 75
"/Users/giorasmacbook/Library/CloudStorage/OneDrive-Personal/MyLife/Giora/לימודים/הנדסאים/שנה ב/A FINAL PROJECT/PokerMate/SEM A FINAL JOBS/OOP Divers/FINAL SESTER A OOP/ConsoleApp1/ConsoleApp1/Classes/CMisc/DiveRank.cs", "C#", 46, 4, 4, 54
"/Users/giorasmacbook/Library/CloudStorage/OneDrive-Personal/MyLife/Giora/לימודים/הנדסאים/שנה ב/A FINAL PROJECT/PokerMate/SEM A FINAL JOBS/OOP Divers/FINAL SESTER A OOP/ConsoleApp1/ConsoleApp1/Classes/CMisc/DiveRankGiven.cs", "C#", 36, 5, 4, 45
"/Users/giorasmacbook/Library/CloudStorage/OneDrive-Personal/MyLife/Giora/לימודים/הנדסאים/שנה ב/A FINAL PROJECT/PokerMate/SEM A FINAL JOBS/OOP Divers/FINAL SESTER A OOP/ConsoleApp1/ConsoleApp1/Classes/CMisc/Item.cs", "C#", 64, 5, 3, 72
"/Users/giorasmacbook/Library/CloudStorage/OneDrive-Personal/MyLife/Giora/לימודים/הנדסאים/שנה ב/A FINAL PROJECT/PokerMate/SEM A FINAL JOBS/OOP Divers/FINAL SESTER A OOP/ConsoleApp1/ConsoleApp1/Classes/CUtility/DiveRegulation.cs", "C#", 49, 7, 4, 60
"/Users/giorasmacbook/Library/CloudStorage/OneDrive-Personal/MyLife/Giora/לימודים/הנדסאים/שנה ב/A FINAL PROJECT/PokerMate/SEM A FINAL JOBS/OOP Divers/FINAL SESTER A OOP/ConsoleApp1/ConsoleApp1/Classes/CUtility/DivingInfo.cs", "C#", 161, 14, 8, 183
"/Users/giorasmacbook/Library/CloudStorage/OneDrive-Personal/MyLife/Giora/לימודים/הנדסאים/שנה ב/A FINAL PROJECT/PokerMate/SEM A FINAL JOBS/OOP Divers/FINAL SESTER A OOP/ConsoleApp1/ConsoleApp1/Classes/CUtility/General Utility/Color.cs", "C#", 67, 3, 0, 70
"/Users/giorasmacbook/Library/CloudStorage/OneDrive-Personal/MyLife/Giora/לימודים/הנדסאים/שנה ב/A FINAL PROJECT/PokerMate/SEM A FINAL JOBS/OOP Divers/FINAL SESTER A OOP/ConsoleApp1/ConsoleApp1/Classes/CUtility/General Utility/Helper.cs", "C#", 33, 6, 4, 43
"/Users/giorasmacbook/Library/CloudStorage/OneDrive-Personal/MyLife/Giora/לימודים/הנדסאים/שנה ב/A FINAL PROJECT/PokerMate/SEM A FINAL JOBS/OOP Divers/FINAL SESTER A OOP/ConsoleApp1/ConsoleApp1/Classes/CUtility/General Utility/Printer.cs", "C#", 351, 66, 25, 442
"/Users/giorasmacbook/Library/CloudStorage/OneDrive-Personal/MyLife/Giora/לימודים/הנדסאים/שנה ב/A FINAL PROJECT/PokerMate/SEM A FINAL JOBS/OOP Divers/FINAL SESTER A OOP/ConsoleApp1/ConsoleApp1/Classes/CUtility/General Utility/Validator.cs", "C#", 275, 13, 33, 321
"/Users/giorasmacbook/Library/CloudStorage/OneDrive-Personal/MyLife/Giora/לימודים/הנדסאים/שנה ב/A FINAL PROJECT/PokerMate/SEM A FINAL JOBS/OOP Divers/FINAL SESTER A OOP/ConsoleApp1/ConsoleApp1/Classes/CUtility/Node.cs", "C#", 80, 9, 8, 97
"/Users/giorasmacbook/Library/CloudStorage/OneDrive-Personal/MyLife/Giora/לימודים/הנדסאים/שנה ב/A FINAL PROJECT/PokerMate/SEM A FINAL JOBS/OOP Divers/FINAL SESTER A OOP/ConsoleApp1/ConsoleApp1/Classes/CUtility/Signature.cs", "C#", 11, 0, 2, 13
"/Users/giorasmacbook/Library/CloudStorage/OneDrive-Personal/MyLife/Giora/לימודים/הנדסאים/שנה ב/A FINAL PROJECT/PokerMate/SEM A FINAL JOBS/OOP Divers/FINAL SESTER A OOP/ConsoleApp1/ConsoleApp1/Classes/CUtility/WorkStamp.cs", "C#", 10, 5, 2, 17
"/Users/giorasmacbook/Library/CloudStorage/OneDrive-Personal/MyLife/Giora/לימודים/הנדסאים/שנה ב/A FINAL PROJECT/PokerMate/SEM A FINAL JOBS/OOP Divers/FINAL SESTER A OOP/ConsoleApp1/ConsoleApp1/Classes/Interfaces/IBorrow.cs", "C#", 5, 4, 0, 9
"/Users/giorasmacbook/Library/CloudStorage/OneDrive-Personal/MyLife/Giora/לימודים/הנדסאים/שנה ב/A FINAL PROJECT/PokerMate/SEM A FINAL JOBS/OOP Divers/FINAL SESTER A OOP/ConsoleApp1/ConsoleApp1/Classes/Interfaces/IDiveable.cs", "C#", 5, 0, 0, 5
"/Users/giorasmacbook/Library/CloudStorage/OneDrive-Personal/MyLife/Giora/לימודים/הנדסאים/שנה ב/A FINAL PROJECT/PokerMate/SEM A FINAL JOBS/OOP Divers/FINAL SESTER A OOP/ConsoleApp1/ConsoleApp1/Classes/Interfaces/ISigner.cs", "C#", 4, 0, 0, 4
"Total", "-", 1849, 196, 164, 2209