"filename", "language", "XML", "C#", "JSON", "Properties", "comment", "blank", "total"
"/Users/giorasmacbook/Library/CloudStorage/OneDrive-Personal/MyLife/Giora/לימודים/הנדסאים/שנה ב/A FINAL PROJECT/PokerMate/SEM A FINAL JOBS/OOP Divers/FINAL SESTER A OOP/ConsoleApp1/ConsoleApp1/Classes/CHumans/Diver.cs", "C#", 0, 133, 0, 0, 17, 9, 159
"/Users/giorasmacbook/Library/CloudStorage/OneDrive-Personal/MyLife/Giora/לימודים/הנדסאים/שנה ב/A FINAL PROJECT/PokerMate/SEM A FINAL JOBS/OOP Divers/FINAL SESTER A OOP/ConsoleApp1/ConsoleApp1/Classes/CHumans/DiverInstructor.cs", "C#", 0, 44, 0, 0, 7, 5, 56
"/Users/giorasmacbook/Library/CloudStorage/OneDrive-Personal/MyLife/Giora/לימודים/הנדסאים/שנה ב/A FINAL PROJECT/PokerMate/SEM A FINAL JOBS/OOP Divers/FINAL SESTER A OOP/ConsoleApp1/ConsoleApp1/Classes/CHumans/Person.cs", "C#", 0, 132, 0, 0, 10, 25, 167
"/Users/giorasmacbook/Library/CloudStorage/OneDrive-Personal/MyLife/Giora/לימודים/הנדסאים/שנה ב/A FINAL PROJECT/PokerMate/SEM A FINAL JOBS/OOP Divers/FINAL SESTER A OOP/ConsoleApp1/ConsoleApp1/Classes/CHumans/User.cs", "C#", 0, 36, 0, 0, 4, 6, 46
"/Users/giorasmacbook/Library/CloudStorage/OneDrive-Personal/MyLife/Giora/לימודים/הנדסאים/שנה ב/A FINAL PROJECT/PokerMate/SEM A FINAL JOBS/OOP Divers/FINAL SESTER A OOP/ConsoleApp1/ConsoleApp1/Classes/CLocations/Address.cs", "C#", 0, 66, 0, 0, 3, 2, 71
"/Users/giorasmacbook/Library/CloudStorage/OneDrive-Personal/MyLife/Giora/לימודים/הנדסאים/שנה ב/A FINAL PROJECT/PokerMate/SEM A FINAL JOBS/OOP Divers/FINAL SESTER A OOP/ConsoleApp1/ConsoleApp1/Classes/CLocations/Country.cs", "C#", 0, 41, 0, 0, 3, 5, 49
"/Users/giorasmacbook/Library/CloudStorage/OneDrive-Personal/MyLife/Giora/לימודים/הנדסאים/שנה ב/A FINAL PROJECT/PokerMate/SEM A FINAL JOBS/OOP Divers/FINAL SESTER A OOP/ConsoleApp1/ConsoleApp1/Classes/CLocations/DivingClub.cs", "C#", 0, 133, 0, 0, 7, 11, 151
"/Users/giorasmacbook/Library/CloudStorage/OneDrive-Personal/MyLife/Giora/לימודים/הנדסאים/שנה ב/A FINAL PROJECT/PokerMate/SEM A FINAL JOBS/OOP Divers/FINAL SESTER A OOP/ConsoleApp1/ConsoleApp1/Classes/CLocations/DivingSite.cs", "C#", 0, 67, 0, 0, 4, 4, 75
"/Users/giorasmacbook/Library/CloudStorage/OneDrive-Personal/MyLife/Giora/לימודים/הנדסאים/שנה ב/A FINAL PROJECT/PokerMate/SEM A FINAL JOBS/OOP Divers/FINAL SESTER A OOP/ConsoleApp1/ConsoleApp1/Classes/CMisc/DiveRank.cs", "C#", 0, 46, 0, 0, 4, 4, 54
"/Users/giorasmacbook/Library/CloudStorage/OneDrive-Personal/MyLife/Giora/לימודים/הנדסאים/שנה ב/A FINAL PROJECT/PokerMate/SEM A FINAL JOBS/OOP Divers/FINAL SESTER A OOP/ConsoleApp1/ConsoleApp1/Classes/CMisc/DiveRankGiven.cs", "C#", 0, 36, 0, 0, 5, 4, 45
"/Users/giorasmacbook/Library/CloudStorage/OneDrive-Personal/MyLife/Giora/לימודים/הנדסאים/שנה ב/A FINAL PROJECT/PokerMate/SEM A FINAL JOBS/OOP Divers/FINAL SESTER A OOP/ConsoleApp1/ConsoleApp1/Classes/CMisc/Item.cs", "C#", 0, 64, 0, 0, 5, 3, 72
"/Users/giorasmacbook/Library/CloudStorage/OneDrive-Personal/MyLife/Giora/לימודים/הנדסאים/שנה ב/A FINAL PROJECT/PokerMate/SEM A FINAL JOBS/OOP Divers/FINAL SESTER A OOP/ConsoleApp1/ConsoleApp1/Classes/CUtility/DiveRegulation.cs", "C#", 0, 49, 0, 0, 7, 4, 60
"/Users/giorasmacbook/Library/CloudStorage/OneDrive-Personal/MyLife/Giora/לימודים/הנדסאים/שנה ב/A FINAL PROJECT/PokerMate/SEM A FINAL JOBS/OOP Divers/FINAL SESTER A OOP/ConsoleApp1/ConsoleApp1/Classes/CUtility/DivingInfo.cs", "C#", 0, 161, 0, 0, 14, 8, 183
"/Users/giorasmacbook/Library/CloudStorage/OneDrive-Personal/MyLife/Giora/לימודים/הנדסאים/שנה ב/A FINAL PROJECT/PokerMate/SEM A FINAL JOBS/OOP Divers/FINAL SESTER A OOP/ConsoleApp1/ConsoleApp1/Classes/CUtility/General Utility/Color.cs", "C#", 0, 67, 0, 0, 3, 0, 70
"/Users/giorasmacbook/Library/CloudStorage/OneDrive-Personal/MyLife/Giora/לימודים/הנדסאים/שנה ב/A FINAL PROJECT/PokerMate/SEM A FINAL JOBS/OOP Divers/FINAL SESTER A OOP/ConsoleApp1/ConsoleApp1/Classes/CUtility/General Utility/Helper.cs", "C#", 0, 33, 0, 0, 6, 4, 43
"/Users/giorasmacbook/Library/CloudStorage/OneDrive-Personal/MyLife/Giora/לימודים/הנדסאים/שנה ב/A FINAL PROJECT/PokerMate/SEM A FINAL JOBS/OOP Divers/FINAL SESTER A OOP/ConsoleApp1/ConsoleApp1/Classes/CUtility/General Utility/Printer.cs", "C#", 0, 351, 0, 0, 66, 25, 442
"/Users/giorasmacbook/Library/CloudStorage/OneDrive-Personal/MyLife/Giora/לימודים/הנדסאים/שנה ב/A FINAL PROJECT/PokerMate/SEM A FINAL JOBS/OOP Divers/FINAL SESTER A OOP/ConsoleApp1/ConsoleApp1/Classes/CUtility/General Utility/Validator.cs", "C#", 0, 275, 0, 0, 13, 33, 321
"/Users/giorasmacbook/Library/CloudStorage/OneDrive-Personal/MyLife/Giora/לימודים/הנדסאים/שנה ב/A FINAL PROJECT/PokerMate/SEM A FINAL JOBS/OOP Divers/FINAL SESTER A OOP/ConsoleApp1/ConsoleApp1/Classes/CUtility/Node.cs", "C#", 0, 80, 0, 0, 9, 8, 97
"/Users/giorasmacbook/Library/CloudStorage/OneDrive-Personal/MyLife/Giora/לימודים/הנדסאים/שנה ב/A FINAL PROJECT/PokerMate/SEM A FINAL JOBS/OOP Divers/FINAL SESTER A OOP/ConsoleApp1/ConsoleApp1/Classes/CUtility/Signature.cs", "C#", 0, 11, 0, 0, 0, 2, 13
"/Users/giorasmacbook/Library/CloudStorage/OneDrive-Personal/MyLife/Giora/לימודים/הנדסאים/שנה ב/A FINAL PROJECT/PokerMate/SEM A FINAL JOBS/OOP Divers/FINAL SESTER A OOP/ConsoleApp1/ConsoleApp1/Classes/CUtility/WorkStamp.cs", "C#", 0, 10, 0, 0, 5, 2, 17
"/Users/giorasmacbook/Library/CloudStorage/OneDrive-Personal/MyLife/Giora/לימודים/הנדסאים/שנה ב/A FINAL PROJECT/PokerMate/SEM A FINAL JOBS/OOP Divers/FINAL SESTER A OOP/ConsoleApp1/ConsoleApp1/Classes/Interfaces/IBorrow.cs", "C#", 0, 5, 0, 0, 4, 0, 9
"/Users/giorasmacbook/Library/CloudStorage/OneDrive-Personal/MyLife/Giora/לימודים/הנדסאים/שנה ב/A FINAL PROJECT/PokerMate/SEM A FINAL JOBS/OOP Divers/FINAL SESTER A OOP/ConsoleApp1/ConsoleApp1/Classes/Interfaces/IDiveable.cs", "C#", 0, 5, 0, 0, 0, 0, 5
"/Users/giorasmacbook/Library/CloudStorage/OneDrive-Personal/MyLife/Giora/לימודים/הנדסאים/שנה ב/A FINAL PROJECT/PokerMate/SEM A FINAL JOBS/OOP Divers/FINAL SESTER A OOP/ConsoleApp1/ConsoleApp1/Classes/Interfaces/ISigner.cs", "C#", 0, 4, 0, 0, 0, 0, 4
"/Users/giorasmacbook/Library/CloudStorage/OneDrive-Personal/MyLife/Giora/לימודים/הנדסאים/שנה ב/A FINAL PROJECT/PokerMate/SEM A FINAL JOBS/OOP Divers/FINAL SESTER A OOP/ConsoleApp1/ConsoleApp1/ConsoleApp1.csproj", "XML", 11, 0, 0, 0, 0, 4, 15
"/Users/giorasmacbook/Library/CloudStorage/OneDrive-Personal/MyLife/Giora/לימודים/הנדסאים/שנה ב/A FINAL PROJECT/PokerMate/SEM A FINAL JOBS/OOP Divers/FINAL SESTER A OOP/ConsoleApp1/ConsoleApp1/Program.cs", "C#", 0, 25, 0, 0, 16, 6, 47
"/Users/giorasmacbook/Library/CloudStorage/OneDrive-Personal/MyLife/Giora/לימודים/הנדסאים/שנה ב/A FINAL PROJECT/PokerMate/SEM A FINAL JOBS/OOP Divers/FINAL SESTER A OOP/ConsoleApp1/ConsoleApp1/bin/Debug/net9.0/ConsoleApp1.deps.json", "JSON", 0, 0, 41, 0, 0, 0, 41
"/Users/giorasmacbook/Library/CloudStorage/OneDrive-Personal/MyLife/Giora/לימודים/הנדסאים/שנה ב/A FINAL PROJECT/PokerMate/SEM A FINAL JOBS/OOP Divers/FINAL SESTER A OOP/ConsoleApp1/ConsoleApp1/bin/Debug/net9.0/ConsoleApp1.runtimeconfig.json", "JSON", 0, 0, 12, 0, 0, 0, 12
"/Users/giorasmacbook/Library/CloudStorage/OneDrive-Personal/MyLife/Giora/לימודים/הנדסאים/שנה ב/A FINAL PROJECT/PokerMate/SEM A FINAL JOBS/OOP Divers/FINAL SESTER A OOP/ConsoleApp1/ConsoleApp1/obj/ConsoleApp1.csproj.nuget.dgspec.json", "JSON", 0, 0, 73, 0, 0, 0, 73
"/Users/giorasmacbook/Library/CloudStorage/OneDrive-Personal/MyLife/Giora/לימודים/הנדסאים/שנה ב/A FINAL PROJECT/PokerMate/SEM A FINAL JOBS/OOP Divers/FINAL SESTER A OOP/ConsoleApp1/ConsoleApp1/obj/ConsoleApp1.csproj.nuget.g.props", "XML", 15, 0, 0, 0, 0, 0, 15
"/Users/giorasmacbook/Library/CloudStorage/OneDrive-Personal/MyLife/Giora/לימודים/הנדסאים/שנה ב/A FINAL PROJECT/PokerMate/SEM A FINAL JOBS/OOP Divers/FINAL SESTER A OOP/ConsoleApp1/ConsoleApp1/obj/ConsoleApp1.csproj.nuget.g.targets", "XML", 2, 0, 0, 0, 0, 0, 2
"/Users/giorasmacbook/Library/CloudStorage/OneDrive-Personal/MyLife/Giora/לימודים/הנדסאים/שנה ב/A FINAL PROJECT/PokerMate/SEM A FINAL JOBS/OOP Divers/FINAL SESTER A OOP/ConsoleApp1/ConsoleApp1/obj/Debug/net9.0/.NETCoreApp,Version=v9.0.AssemblyAttributes.cs", "C#", 0, 3, 0, 0, 1, 1, 5
"/Users/giorasmacbook/Library/CloudStorage/OneDrive-Personal/MyLife/Giora/לימודים/הנדסאים/שנה ב/A FINAL PROJECT/PokerMate/SEM A FINAL JOBS/OOP Divers/FINAL SESTER A OOP/ConsoleApp1/ConsoleApp1/obj/Debug/net9.0/ConsoleApp1.AssemblyInfo.cs", "C#", 0, 9, 0, 0, 9, 5, 23
"/Users/giorasmacbook/Library/CloudStorage/OneDrive-Personal/MyLife/Giora/לימודים/הנדסאים/שנה ב/A FINAL PROJECT/PokerMate/SEM A FINAL JOBS/OOP Divers/FINAL SESTER A OOP/ConsoleApp1/ConsoleApp1/obj/Debug/net9.0/ConsoleApp1.GeneratedMSBuildEditorConfig.editorconfig", "Properties", 0, 0, 0, 15, 0, 1, 16
"/Users/giorasmacbook/Library/CloudStorage/OneDrive-Personal/MyLife/Giora/לימודים/הנדסאים/שנה ב/A FINAL PROJECT/PokerMate/SEM A FINAL JOBS/OOP Divers/FINAL SESTER A OOP/ConsoleApp1/ConsoleApp1/obj/Debug/net9.0/ConsoleApp1.GlobalUsings.g.cs", "C#", 0, 7, 0, 0, 1, 1, 9
"/Users/giorasmacbook/Library/CloudStorage/OneDrive-Personal/MyLife/Giora/לימודים/הנדסאים/שנה ב/A FINAL PROJECT/PokerMate/SEM A FINAL JOBS/OOP Divers/FINAL SESTER A OOP/ConsoleApp1/ConsoleApp1/obj/Debug/net9.0/ConsoleApp1.sourcelink.json", "JSON", 0, 0, 1, 0, 0, 0, 1
"/Users/giorasmacbook/Library/CloudStorage/OneDrive-Personal/MyLife/Giora/לימודים/הנדסאים/שנה ב/A FINAL PROJECT/PokerMate/SEM A FINAL JOBS/OOP Divers/FINAL SESTER A OOP/ConsoleApp1/ConsoleApp1/obj/project.assets.json", "JSON", 0, 0, 125, 0, 0, 0, 125
"Total", "-", 28, 1893, 252, 15, 223, 182, 2593